#######
#.B   #
# #B. #
#   B##
#&  .#
##  ##
 ####